NO textures/north_textures.xpm
SO textures/south_textures.xpm
WE textures/west_textures.xpm
EA textures/east_textures.xpm

F 0,0,0
C 255,255,255

        1111111111111111111111111
        1000000000000000000000001
        1011000000000000000000001
        1001000000000000000000001
111111111011000001110000000000001
100000000011000001110111111111111
11110111111111011100000010001
11110111111110011101010010001
11000000000100011100000010001
100000000W0000001100000010001
10000000000000001101010010001
1100000111010001111101111000111
11110111 1110001 101111010001
11111111 1111111 111111111111