NO check_NO
SO check_SO
WE check_WE
EA check_EA

C    55  ,         25  ,          0 
F    255 ,  255 , -012 

        111111111 1111111111   111111
        10000000011100001111   110001
        10110000011100000000111111111
        1001000000000000000000001
111111111011000001110000000000001
100000000011000001110111111111111
11110111111101011100000010001
1111011111111 111101011110001
1100000011010101110001  10001
10000000000000001100011110001
10000000000000001101010010001
11000001110101001111011110N0111
11110111 1110101 101111010001
11111111 1111111 11111111111





