NO aaaaaaaaaaaaaaa
SO textures/blue_wall.xpm
WE textures/orange_wall.xpm
EA textures/purple_wall.xpm

F 0,100,255
C 42,0,100

1111111111111111111111111
1000000000000011000000001
1000000100000000000000011
1000001 10000000000111111
1000000100000000000000001
100000000000S000000001111
1100000000000000000001
1111000000000000000001111
1111101111111111100111101
1000000000000000000000001
1000011111000000000011001
10000000001100000001  101
11111111111111111111  111